sent_to,no. PFDs,overdue,pending,received,% received
NHS England,20,10,0,10,50.0
Care Quality Commission,15,10,0,5,33.3
Department of Health and Social Care,13,6,0,7,53.8
Midlands Partnership NHS Foundation trust,6,4,0,2,33.3
Clinical Commissioning Group,5,2,0,3,60.0
Aneurin Bevan University Health Board,5,1,0,4,80.0
Leeds Teaching Hospitals NHS Trust,4,2,0,2,50.0
NHS Trafford Clinical Commissioning Group,4,2,0,2,50.0
The Secretary of State for Health and Social Care,4,3,0,1,25.0
Greater Manchester Health & Social Care Partnership,4,2,0,2,50.0
Home Office,4,3,0,1,25.0
Department for Transport,3,1,0,2,66.7
Dept. of Health and Social Care,3,2,0,1,33.3
SoS for Health and Social Care,3,1,0,2,66.7
Birmingham and Solihull Mental Health Foundation Trust,3,1,0,2,66.7
Public Health England,3,1,0,2,66.7
Highways England,3,0,0,3,100.0
Metropolitan Police Service,3,0,0,3,100.0
Welsh Ambulance Services NHS Trust,3,2,0,1,33.3
Medicines & Healthcare products Regulatory Agency,3,1,0,2,66.7
Civil Aviation Authority,2,0,0,2,100.0
NHS Pathways,2,1,0,1,50.0
Cwm Taf Morgannwg University Health Board,2,1,0,1,50.0
Milton Keynes University Hospital,2,1,0,1,50.0
Staffordshire Fire and Rescue Service HQ,2,0,0,2,100.0
St Pancras Hospital,2,0,0,2,100.0
Royal National Lifeboat Institution,2,0,0,2,100.0
Metropolitan Police,2,1,0,1,50.0
Medway NHS Foundation Trust,2,1,0,1,50.0
EPUT,2,0,0,2,100.0
Sheffield Teaching Hospitals NHS Foundation Trust,2,0,0,2,100.0
Secretary of State,2,2,0,0,0.0
East Lancashire Hospitals NHS Trust,2,1,0,1,50.0
National Institute for Health & Care Excellence,2,1,0,1,50.0
Norfolk and Norwich University Hospital,2,0,0,2,100.0
Royal London Hospital,2,0,0,2,100.0
North Bristol NHS Trust,2,1,0,1,50.0
Maritime Coastguard Agency,2,0,0,2,100.0
Royal Free Hospital,2,0,0,2,100.0
National Police Chiefs’ Council,2,2,0,0,0.0
Greater Manchester Police,2,0,0,2,100.0
HM Prison and Probation Service,2,2,0,0,0.0
Network Rail,2,0,0,2,100.0
Healthcare Safety Investigation Branch,2,0,0,2,100.0
Central & North West London NHS Foundation Trust,2,1,0,1,50.0
Manchester University NHS Foundation Trust,2,0,0,2,100.0
Home Secretary,2,2,0,0,0.0
Homerton Healthcare NHS Foundation Trust,2,1,0,1,50.0
Kent County Council,2,1,0,1,50.0
North West Ambulance Service,2,0,0,2,100.0
North East London Foundation Trust,2,1,0,1,50.0
Egton Medical Information Systems,2,1,0,1,50.0
NHS Digital,2,0,0,2,100.0
Calderdale Council,2,2,0,0,0.0
Barts Health NHS Trust,2,1,0,1,50.0
University Hospital Southampton NHS Foundation Trust,2,0,0,2,100.0
University Health Board,2,1,0,1,50.0
United Lincolnshire Hospital Trust,2,1,0,1,50.0
Office for Product Safety and Standards,1,1,0,0,0.0
Paul Wainwright Construction Services Ltd,1,0,0,1,100.0
POM-EKO,1,1,0,0,0.0
PCRSteel Ltd.,1,1,0,0,0.0
Oxleas NHS Trust,1,0,0,1,100.0
Oxleas NHS Foundation Trust,1,1,0,0,0.0
One Hosing Group,1,1,0,0,0.0
"Tees, Esk and Wear Valley NHS Trust",1,1,0,0,0.0
Oakridge House Residential Home,1,1,0,0,0.0
Peabody Trust,1,0,0,1,100.0
Nottingham West,1,1,0,0,0.0
Vascular Access Society of Britain and Ireland,1,1,0,0,0.0
Nottingham University Hospital NHS Trust,1,0,0,1,100.0
Nottingham North and East,1,1,0,0,0.0
Nursing and Midwifery Council,1,1,0,0,0.0
Vantage Drilling Company,1,0,0,1,100.0
North West Motorway Police Group,1,0,0,1,100.0
University Hospitals of Birmingham NHS Foundation Trust,1,0,0,1,100.0
University Hospital of Wales,1,1,0,0,0.0
Pennine Care NHS Foundation Trust,1,0,0,1,100.0
Pennine Care NHS Trust,1,1,0,0,0.0
University Hospital of North Midalnds,1,0,0,1,100.0
Powys County Council,1,1,0,0,0.0
Prembrokeshire County Council,1,1,0,0,0.0
University Hospital of Derby and Burton,1,1,0,0,0.0
Primary Care Support England,1,1,0,0,0.0
Princess Alexandra Hospital,1,1,0,0,0.0
Priory Hospital,1,0,0,1,100.0
Queen Elizabeth Hospital,1,0,0,1,100.0
Queen’s Hospital,1,0,0,1,100.0
Nottingham City Clinical Commissioning Groups,1,1,0,0,0.0
North Laine Medical Centre,1,1,0,0,0.0
Wales Ambulance Service NHS Trust,1,1,0,0,0.0
National Association of Ambulance Medical Directors,1,1,0,0,0.0
Western Sussex Hospital Trust,1,0,0,1,100.0
Weymouth Street Hospital,1,0,0,1,100.0
Whipps Cross Hospital,1,0,0,1,100.0
Whirlpool UK Appliances,1,0,0,1,100.0
Whiston Hospital,1,0,0,1,100.0
National Infusion and Vascular Access Society,1,1,0,0,0.0
Whittington Hospital,1,0,0,1,100.0
Reed Nursing Trust,1,1,0,0,0.0
Widnes Hall Care Home,1,1,0,0,0.0
NHSBT Head Office,1,1,0,0,0.0
Woolwich Station Medical Centre,1,1,0,0,0.0
Wrexham County Borough Council,1,0,0,1,100.0
NHS Improvement,1,0,0,1,100.0
NHS England: Department of Health,1,1,0,0,0.0
National Institute for Health and Care Excellence,1,1,0,0,0.0
National Police Chiefs Council,1,1,0,0,0.0
West Sussex County Council,1,0,0,1,100.0
West Suffolk Hospital,1,0,0,1,100.0
National Trading Standards Board,1,1,0,0,0.0
West Park Hospital,1,0,0,1,100.0
West Midlands Ambulance Service,1,0,0,1,100.0
New Lodge Nursing Home,1,1,0,0,0.0
Newark and Sherwood,1,1,0,0,0.0
Newton House formerly Regency Hospital,1,1,0,0,0.0
Norfolk County Council,1,0,0,1,100.0
Welsh Ambulance Service Trust WAST,1,1,0,0,0.0
Norfolk and Suffolk NHS Foundation Trust,1,1,0,0,0.0
North & Mid Wales Trunk Road Agency,1,0,0,1,100.0
We Are With You charity,1,0,0,1,100.0
North East Ambulance Service,1,1,0,0,0.0
Warwick Hospital,1,0,0,1,100.0
REDACTED,1,1,0,0,0.0
Richmond Clinic,1,0,0,1,100.0
Renal Association,1,1,0,0,0.0
South Yorkshire Police HQ,1,0,0,1,100.0
The Highways Authority,1,1,0,0,0.0
The Home Secretary,1,1,0,0,0.0
"St John’s College, Oxford University",1,0,0,1,100.0
The Limes Sheltered Housing,1,0,0,1,100.0
Spire Harpenden Hospital,1,0,0,1,100.0
Specsavers UK,1,0,0,1,100.0
South West Yorkshire Partnership,1,0,0,1,100.0
Tameside General Hospital,1,1,0,0,0.0
South Wales Police,1,0,0,1,100.0
South London and Maudsley NHS Foundation Trust,1,1,0,0,0.0
South Lincolnshire Clinical Commissioning Group,1,1,0,0,0.0
South Central Ambulance Service,1,1,0,0,0.0
The National Institute for Health and Care Excellence,1,1,0,0,0.0
SoS for DCMS,1,0,0,1,100.0
The College of Policing,1,1,0,0,0.0
Stockport Clinical Commissioning Group,1,0,0,1,100.0
Stockport NHS Foundation Trust,1,1,0,0,0.0
Stockport NHS Trust,1,1,0,0,0.0
Stoneham Bass,1,0,0,1,100.0
Suffolk Safeguarding Partnership,1,0,0,1,100.0
The Castle Rock Group,1,0,0,1,100.0
Surrey Police,1,1,0,0,0.0
Surrey and Borders Partnership NHS Foundation Trust,1,0,0,1,100.0
Surrey and Sussex Healthcare NHS Trust,1,0,0,1,100.0
Sussex Partnership Foundation NHS Trust,1,0,0,1,100.0
Sussex Partnership NHS Trust,1,1,0,0,0.0
The Barking Havering and Redbridge University NHS Trust,1,1,0,0,0.0
Tettenhall Medical Practice,1,0,0,1,100.0
Sustainable Improvement Team NHS England,1,1,0,0,0.0
Tameside & Glossop Integrated Care NHS Foundation Trust,1,0,0,1,100.0
Tameside CCG,1,1,0,0,0.0
Sherwood Forest Hospitals NHS Foundation Trust,1,0,0,1,100.0
The Northern Care Alliance NHS Trust,1,1,0,0,0.0
The Peligoni Club,1,1,0,0,0.0
Royal College of Radiologists,1,0,0,1,100.0
Riverside Rest Home,1,1,0,0,0.0
Rosehill House Care Home,1,1,0,0,0.0
Rossendale Nursing Home,1,0,0,1,100.0
Rotherham Borough Council,1,0,0,1,100.0
Royal Brompton Hospital,1,0,0,1,100.0
Royal College of Anaesthetists,1,1,0,0,0.0
Turning Point,1,0,0,1,100.0
Royal College of GPs,1,1,0,0,0.0
Royal College of Midwives,1,1,0,0,0.0
Royal College of Nursing,1,1,0,0,0.0
Royal College of Nursing and Midwifery,1,1,0,0,0.0
Royal College of Obstetricians and Gynaecologists,1,1,0,0,0.0
Royal College of Obstetrics and Gynaecology,1,1,0,0,0.0
Royal College of Physicians,1,0,0,1,100.0
Royal Cornwall Hospital,1,1,0,0,0.0
The Portland Hospital,1,0,0,1,100.0
Transport and Rural Affairs at Suffolk County Council,1,0,0,1,100.0
Trafford Metropolitan Borough Council,1,1,0,0,0.0
Three Sisters Care Ltd,1,1,0,0,0.0
Royal Pharmaceutical Society,1,0,0,1,100.0
Royal Stoke University Hospital,1,1,0,0,0.0
Royal United Hospitals,1,0,0,1,100.0
Rush Green Medical Centre,1,1,0,0,0.0
Rushcliffe,1,1,0,0,0.0
The Royal College of General Practitioners,1,1,0,0,0.0
SE Galvanisers,1,1,0,0,0.0
SECAMBS,1,1,0,0,0.0
Sandwell and West Birmingham NHS Trust,1,0,0,1,100.0
Secretary for State for Health,1,1,0,0,0.0
The Priory Group,1,0,0,1,100.0
AACE’s National Directors of Operations Group,1,1,0,0,0.0
Maylands Health Care,1,1,0,0,0.0
Morton Hall Immigration Removal Centre,1,1,0,0,0.0
"Children’s Services, Haringey Council",1,1,0,0,0.0
DHL Supply Chain UKI,1,0,0,1,100.0
Covid-19 Pandemic Response Service,1,1,0,0,0.0
Coventry University,1,0,0,1,100.0
Coventry & Warwickshire Partnership NHS Trust,1,1,0,0,0.0
Cole Valley Care Ltd,1,0,0,1,100.0
Clinisys UK,1,1,0,0,0.0
City and County Healthcare Group,1,0,0,1,100.0
Chair of Association of Ambulance Chief Executives,1,1,0,0,0.0
Department for Digital Culture Media and Sport,1,1,0,0,0.0
Ceredigion County Council,1,0,0,1,100.0
Care UK,1,1,0,0,0.0
Care Outlook Ltd,1,0,0,1,100.0
Camden Council,1,0,0,1,100.0
Camden & Islington NHS Trust,1,1,0,0,0.0
Cambridge County Council,1,0,0,1,100.0
CAMIS,1,1,0,0,0.0
"Department for Business, Energy and Industrial Strategy",1,0,0,1,100.0
Department for Education,1,0,0,1,100.0
Bucher Municipal Ltd,1,0,0,1,100.0
Dorset Police,1,0,0,1,100.0
East & North Hertfordshire NHS Trust,1,0,0,1,100.0
EURO-EKO,1,1,0,0,0.0
EKO-INVEST,1,1,0,0,0.0
EFAS,1,1,0,0,0.0
Durham County Council,1,0,0,1,100.0
Driver and Vehicle Standards Agency,1,1,0,0,0.0
Driver & Vehicle Licensing Agency,1,0,0,1,100.0
Disclosure and Barring Service,1,0,0,1,100.0
"Department for Foreign, Commonwealth and Development Affairs",1,0,0,1,100.0
Devon and Cornwall Constabulary,1,1,0,0,0.0
Devon Partnership NHS Trust,1,0,0,1,100.0
Devon County Council,1,1,0,0,0.0
Derriford Hospital,1,0,0,1,100.0
Department of Transport,1,0,0,1,100.0
Department of Environment Food and Rural Affairs,1,1,0,0,0.0
Department of Business Energy and Industrial Strategy,1,1,0,0,0.0
Byron Hamburgers,1,1,0,0,0.0
British Society for Allergy and Clinical Immunology,1,1,0,0,0.0
Moorfields Eye Hospital NHS Foundation Trust,1,0,0,1,100.0
Alexandra View Care Home,1,0,0,1,100.0
Barnsley Hospital NHS Trust,1,0,0,1,100.0
BMI Health Care,1,1,0,0,0.0
Avon and Wiltshire Mental Health NHS Trust,1,0,0,1,100.0
Association of Anaesthetists,1,1,0,0,0.0
Association of Ambulance Chief Executives,1,1,0,0,0.0
Ashford Borough Council,1,1,0,0,0.0
Ashfield Surgery Sutton Coldfield,1,0,0,1,100.0
Advisory Council on the Misuse of Drugs,1,1,0,0,0.0
Barts and Whipps Trust,1,0,0,1,100.0
Adult and Community Services Suffolk County Council,1,1,0,0,0.0
Adult Social Services,1,0,0,1,100.0
Adult Safeguarding Kent County Council,1,1,0,0,0.0
Adult Safeguarding Civic Centre,1,0,0,1,100.0
"Acute Mental Health Services, West London NHS Trust",1,1,0,0,0.0
Able Care and Support Services Ltd,1,0,0,1,100.0
AMEY,1,1,0,0,0.0
Barts Health NHS Foundation Trust,1,0,0,1,100.0
Basildon and Thurrock University Hospital Trust,1,1,0,0,0.0
British Renal Society,1,1,0,0,0.0
Birmingham and Solihull CCG,1,0,0,1,100.0
British Medical Association,1,1,0,0,0.0
British Board of Agreement,1,0,0,1,100.0
Brighton and Hove City Council,1,1,0,0,0.0
Borough Care,1,0,0,1,100.0
Boots UK Ltd,1,1,0,0,0.0
Blackpool CCG,1,0,0,1,100.0
Black Country NHS Foundation Trust,1,1,0,0,0.0
Birmingham City Council,1,1,0,0,0.0
Bassetlaw,1,0,0,1,100.0
Betsi Cadwaladr University Local Health Board,1,0,0,1,100.0
Betsi Cadwaladr University Health Board BCUHB,1,1,0,0,0.0
Betsi Cadwaladr University Health Board,1,1,0,0,0.0
Belgravia Care Home Ltd,1,0,0,1,100.0
Beechdene Residential Home,1,1,0,0,0.0
Bedfordshire Police,1,0,0,1,100.0
Bedford Hospital NHS Trust,1,0,0,1,100.0
East London Foundation Trust,1,1,0,0,0.0
East London NHS Trust,1,0,0,1,100.0
East Midlands Ambulance Service NHS Trust,1,1,0,0,0.0
Jubilee Court Nursing Home,1,1,0,0,0.0
Leek Health Centre,1,1,0,0,0.0
Land Owner,1,1,0,0,0.0
Lambeth Borough Council,1,0,0,1,100.0
LNER,1,0,0,1,100.0
Kockey Road Medical Centre,1,0,0,1,100.0
Kernow Clinical Commissioning Group,1,1,0,0,0.0
Kent and Medway Cancer Collaborative,1,1,0,0,0.0
Joint Royal Colleges Ambulance Liaison Committee,1,1,0,0,0.0
London Ambulance Service,1,0,0,1,100.0
Jet2.com Ltd,1,0,0,1,100.0
James Paget University Hospital,1,0,0,1,100.0
James Cook University Hospital,1,0,1,0,0.0
International Maritime Organisation,1,1,0,0,0.0
Informa Healthcare,1,1,0,0,0.0
Independent Monitoring Board,1,0,0,1,100.0
Human Kind Charity,1,1,0,0,0.0
Lincolnshire County Council,1,0,0,1,100.0
London Borough of Tower Hamlets,1,0,0,1,100.0
East Suffolk and North Essex NHS Foundation Trust,1,0,0,1,100.0
ACPO,1,1,0,0,0.0
Ministry of Justice,1,1,0,0,0.0
Ministry of Defence,1,1,0,0,0.0
Ministry for Housing and Local Government,1,0,0,1,100.0
Mid and South Essex NHS Foundation Trust,1,0,0,1,100.0
Mid Yorkshire Hospitals NHS Trust,1,0,0,1,100.0
Medway Maritime Hospital,1,0,0,1,100.0
Meade Close Care Home,1,0,0,1,100.0
Marble Ideas Ltd,1,0,0,1,100.0
London Fire Brigade,1,0,0,1,100.0
Mansfield and Ashfield,1,1,0,0,0.0
Manchester University NHS Trust,1,0,0,1,100.0
Maidstone and Tunbridge Wells NHS Foundation Trust,1,0,0,1,100.0
Luton Borough Council,1,0,0,1,100.0
Long Furlong Medical Centre,1,1,0,0,0.0
London and South Eastern Railway,1,0,0,1,100.0
London Underground,1,1,0,0,0.0
Housing of Vulnerable People Building Safety,1,0,0,1,100.0
Hounslow Borough Council,1,0,0,1,100.0
Holmleigh Care Homes Ltd,1,0,0,1,100.0
Friendship Care and Housing Limited,1,1,0,0,0.0
Great Ormond Street Hospital NHS Trust,1,0,0,1,100.0
Gloucestershire Hospitals NHS Trust,1,0,0,1,100.0
Gloucestershire Hospital NHS Foundation Trust,1,0,0,1,100.0
George Eliot Hospital NHS Trust Nuneaton Warwickshire,1,1,0,0,0.0
Gateshead Health Foundation Trust,1,1,0,0,0.0
GRS Recovery,1,0,0,1,100.0
G4S,1,1,0,0,0.0
Food Standards Agency,1,1,0,0,0.0
Highways England National Traffic Operations Centre,1,0,0,1,100.0
First Response Group,1,1,0,0,0.0
FA Group,1,1,0,0,0.0
Essex Police,1,1,0,0,0.0
Essex Partnership University NHS Foundation Trust,1,0,0,1,100.0
England Boxing,1,0,0,1,100.0
Emsworth Surgery,1,0,0,1,100.0
Emergency Call Prioritisation Advisory Group,1,1,0,0,0.0
Great Western Railway,1,0,0,1,100.0
Greater Manchester Integrated Care,1,0,0,1,100.0
Greater Manchester Mental Health NHS Foundation Trust,1,0,0,1,100.0
Gwent Police,1,1,0,0,0.0
"Highways Authority, Cornwall Council",1,1,0,0,0.0
Highways Agency Essex County Council,1,0,0,1,100.0
Health and Safety Executive,1,0,0,1,100.0
Health and Communities Wakefield,1,0,0,1,100.0
Health Education England,1,1,0,0,0.0
Havering Highways,1,1,0,0,0.0
Hart Care Nursing and Residential Home,1,0,0,1,100.0
Harbour Healthcare,1,1,0,0,0.0
Hampshire County Council,1,0,0,1,100.0
HMPS,1,0,0,1,100.0
HMP Wymott,1,1,0,0,0.0
HMP Portland,1,0,0,1,100.0
HMP Pentonville,1,1,0,0,0.0
HMP Garth,1,0,0,1,100.0
HMP Dovegate,1,0,0,1,100.0
Your Housing,1,1,0,0,0.0
